XXXXXXXXXXXXXXXXXXXXXXXXXXXXXXXXXXXXXXXX
XO                                     X
X                                      X
X                                      X
X                                      X
X                                      X
X                                      X
X                                      X
X                                      X
X                                      X
X                                      X
X                                      X
X                                      X
X                                      X
X                                      X
X                                      X
X                                      X
X                                      X
X                                      X
X                                      X
X                                      X
X                                      X
X                                      X
X                                      X
X                                      X
X                                      X
X                                      X
X                                      X
X                                      X
X                                      X
X                                      X
X                                      X
X                                      X
X                                      X
X                                      X
X                                      X
X                                      X
X                                      X
X                                      X
XXXXXXXXXXXXXXXXXXXXXXXXXXXXXXXXXXXXXXXX
{
    "easyEnemy"="Goblin",
    "hardEnemy"="Orc"
}