XXXXXXXXXXXXXXXXXXXXXXXXXXXXXXXXXXXXXXX
X                                    TX
X G        XX                         X
X          XX     XXXXXXXXXXXXXXXXXX  X
X                 X                X  X
XXXXXXXXXXXXX     X                X  X
X                 X    T   B       X  X
X     XX    XX    X                X  X
X     XX    XX    X                X  X
X                 XXXXXX           X  X
X         G                        X  X
X                                  X  X
X     XX    XX    XXXXXXXXXXXXXXXXXX  X
X     XX    XX                        X
X                                     X
X                                     X
X       XXXXXXXXXXXXXXXXXX            X
X                                     X
X                                     X
X            G       XXXXXXXXXXXXXXXXXX
X                               T     X
X                                     X
X       XXXXXXXXXXXXXXXXXX            X
X                                     X
X                                     X
XXXXXX XXXXXXXXX                      X
X              X                      X
X         G    X       G       G      X
X              X                      X
XX XXXXXXXXX  XX                      X
X    G         X                      X
X          T   X           G          X
XXXXXXX XXXXXXXX                      X
X    G         X                      X
X                                     X
XXXXXXXXXXXXXXXXXXXXXXXXXXX           X
X                              XX     X
XT   X O  X G  X    X    X     XX     X
X                                     X
XXXXXXXXXXXXXXXXXXXXXXXXXXXXXXXXXXXXXXX