XXXXXXXXXXXXXXXXXXXXXXXXXXXXXXXXXXXXXXXX
X                                     TX
X E        XX                          X
X          XX     XXXXXXXXXXXXXXXXXX   X
X                 X                X   X
XXXXXXXXXXXXX     X                X   X
X                 X    T   B       X   X
X     XX    XX    X                X   X
X     XX    XX    X                X   X
X                 XXXXXX           X   X
X         E                        X   X
X                                  X   X
X     XX    XX    XXXXXXXXXXXXXXXXXX   X
X     XX    XX                         X
X                                      X
X                                      X
X       XXXXXXXXXXXXXXXXXX             X
X                                      X
X                                      X
X            E       XXXXXXXXXXXXXXXXXXX
X                               T      X
X                                      X
X       XXXXXXXXXXXXXXXXXX             X
X                                      X
X                                      X
XXXXXX XXXXXXXXX                       X
X              X                       X
X         E    X       E       E       X
X              X                       X
XX XXXXXXXXX  XX                       X
X    E         X                       X
X          T   X           E           X
XXXXXXX XXXXXXXX                       X
X    E         X                       X
X                                      X
XXXXXXXXXXXXXXXXXXXXXXXXXXX            X
X                              XX      X
XT   X O  X E  X    X    X     XX      X
X                                      X
XXXXXXXXXXXXXXXXXXXXXXXXXXXXXXXXXXXXXXXX