XXXXXXXXXXXXXXXXXXXXXXXXXXXXXXXXXXXXXXX
X                                     X
X          XX                         X
X          XX     XXXXXXXXXXXXXXXXXX  X
X                 X                X  X
XXXXXXXXXXXXX     X                X  X
X                 X                X  X
X     XX   XX     X                X  X
X     XX   XX     X                X  X
X                 XXXXXX           X  X
X                                  X  X
X     XX   XX                      X  X
X     XX   XX     XXXXXXXXXXXXXXXXXX  X
X                                     X
X                                     X
X                                     X
X       XXXXXXXXXXXXXXXXXX            X
X                                     X
X                                     X
X                    XXXXXXXXXXXXXXXXXX
X                                     X
X                                     X
X       XXXXXXXXXXXXXXXXXX            X
X                                     X
X                                     X
XXXXXX XXXXXXXXX                      X
X              X                      X
X              X                      X
X              X                      X
XX XXXXXXXXX  XX                      X
X              X                      X
X              X                      X
XXXXXXX XXXXXXXX                      X
X              X                      X
X                                     X
XXXXXXXXXXXXXXXXXXXXXXXXXXX           X
X                              XX     X
X    X    X    X    X    X     XX     X
X                                     X
XXXXXXXXXXXXXXXXXXXXXXXXXXXXXXXXXXXXXXX